30 20

14 14 14 14 14 14 14 14 14 14 14 14 14 14 14 14 14 14 14 14 14 14 14 14 14  14 14 14 14 14
14 14 14 14 14 14 14 14 14 14 14 14 14 14 14 14 14 14 14 14 14 14 14 14 14  14 14 14 14 14
14 14 14 15 15 15 15 15 15 15 14 14 14 14 14 14 14 14 14 14 14 14 14 14 14  14 14 14 14 14
14 14 14 15 14 14 14 14 14 15 14 14 14 14 14 14 14 14 14 14 14 14 14 14 14  14 14 14 14 14
14 14 14 15 14 14 14 14 14 14 14 14 14 14 14 14 14 14 14 14 14 14 14 14 14  14 14 14 14 14
14 14 14 15 14 15 15 15 14 14 15 14 14 14 14 14 14 14 14 14 14 14 14 14 14  14 14 14 14 14
16 17 18 15 14 15 16 17 18 14 15 14 14 14 14 14 14 14 14 14 14 14 14 14 14  14 14 14 14 14
19 20 21 15 14 15 19 20 21 14 15 15 15 15 14 14 14 14 14 14 14 14 14 14 14  14 14 14 14 14
22 23 24 15 14 15 22 23 24 14 14 14 14 15 14 14 14 14 14 14 14 14 14 14 14  14 14 14 14 14
14 14 15 15 15 15 15 15 15 15 15 15 14 15 15 15 15 14 14 14 14 14 14 14 14  14 14 14 14 14
14 14 14 15 16 17 18 14 14 14 15 14 15 16 17 18 15 14 14 14 14 14 14 14 14  14 14 14 14 14
16 17 18 15 19 20 21 14 14 14 15 14 15 19 20 21 15 14 14 14 14 14 14 14 14  14 14 14 14 14
19 20 21 15 22 23 24 16 17 18 15 15 15 22 23 24 14 14 14 14 14 14 14 14 14  14 14 14 14 14
22 23 24 15 15 15 15 19 20 21 14 14 15 15 15 15 15 14 14 14 14 14 14 14 14  14 14 14 14 14
14 14 14 14 14 14 15 22 23 24 14 14 15 14 14 14 14 14 14 14 14 14 14 14 14  14 14 14 14 14
16 17 18 15 15 15 15 14 14 15 15 15 15 15 14 14 14 14 14 14 14 14 14 14 14  14 14 14 14 14
19 20 21 15 14 14 14 14 14 15 16 17 18 15 14 14 14 14 14 14 14 14 14 14 14  14 14 14 14 14
22 23 24 15 14 14 14 14 14 15 19 20 21 15 15 15 15 15 15 14 14 14 14 14 14  14 14 14 14 14
15 15 15 15 15 15 15 15 15 15 22 23 24 14 14 14 14 14 14 14 15 14 14 14 14  14 14 14 14 14
16 17 18 14 14 14 14 14 14 14 14 14 14 14 14 14 14 14 14 14 14 14 14 14 14  14 14 14 14 14


