20 20

2 2 2 2 2 2 2 2 2 2 2 2 2 2 2 2 2 2 2 2
1 1 1 1 1 5 6 7 1 1 1 1 1 5 6 7 5 6 7 2
2 5 6 7 1 8 9 10 1 5 6 7 1 8 9 10 8 9 10 2
2 8 9 10 1 11 12 13 1 8 9 10 1 11 12 13 11 12 13 2
2 11 12 13 1 1 1 1 1 11 12 13 1 1 1 1 1 1 1 2
2 5 6 7 1 2 2 2 5 6 7 2 2 2 1 2 2 2 1 2
2 8 9 10 1 1 1 1 8 9 10 1 1 1 1 1 1 1 1 2
2 11 12 13 5 6 7 1 11 12 13 1 2 2 2 2 1 2 2 2
2 1 1 1 8 9 10 1 1 1 1 1 1 1 1 1 1 1 1 2
2 1 2 1 11 12 13 1 2 2 1 5 6 7 1 5 6 7 1 2
2 1 2 1 1 1 1 1 1 1 1 8 9 10 1 8 9 10 1 2
2 1 2 1 5 6 7 5 6 7 1 11 12 13 1 11 12 13 1 2
2 1 1 1 8 9 10 8 9 10 1 1 1 1 1 1 1 1 1 2
2 0 1 0 11 12 13 11 12 13 1 2 2 2 1 2 2 2 1 2
2 1 1 1 1 1 1 1 1 1 1 1 1 1 1 1 1 2 1 2
2 1 5 6 7 5 6 7 1 2 2 2 1 5 6 7 1 2 1 2
2 1 8 9 10 8 9 10 1 1 2 1 1 8 9 10 1 1 1 2
2 1 11 12 13 11 12 13 0 1 2 1 0 11 12 13 0 1 2 2
2 1 1 1 1 1 1 1 1 1 1 1 1 1 1 1 1 1 1 1
2 2 2 2 2 2 2 2 2 2 2 2 2 2 2 2 2 2 2 2
